00777700
00777700
00577400
00077000
66677666
00077000
00377201
00H77700
00777710
03777720
07777770
0577F740
0077H700
00777700
007S7700
03777720
17777770
07H77770
07777S70
07777770
0H745770
07700770
07700770
07H00770
07700770
07723770
077H7770
057S7740
00577400
00077000
00377200
007H7700
03SF7720
07777770
07777770
07745H70
07400570
07000070
07000070
07210370
0H701770
07723H70
077S7770
05777740
00H77700
017H7700
00777700
00577400
00077000
66677666