0000000000
0221001220
0112332210
0221001220
0211111120
0112332210


Max uderzen 3