07777770
07777770
07777770
077F7770
07777771
07777770
07777770
07777770
077F7770
07777771
07777770
07777770
07777770
077F7770
07777771
07777770
07777770
07777770
077F7770
07777771
07777770
07777770
07777770
077F7770
07777771