00777700
00777700
00577400
00077000
66677666
00077000
00377201
00777700
00777710
03H77720
07777770
0577H740
00777700
00777700
007H7700
03777720
17777770
07H77770
0777H770
07777S70
07745770
07700770
07700770
07700H70
07700770
07723770
07777770
05777740
00577400
00077000
00377200
00777700
03777720
07777770
07777770
07745770
07400570
07000070
07000070
07210370
07701770
07723770
07777770
05777740
00777700
01777700
00777700
00577400
00077000
66677666